

NO ./textures/fakenorth.xpm
SO  ./textures/fakesouth.xpm

WE      ./textures/fakewest.xpm
EA 				./textures/fakeeast.xpm



F 220,100,255
 C 0,0,0

111111111
100000001
10N001001
100001101
100000101
100100101
100000101
100000001
111111111
