

NO ./textures/fakenorth.xpm
SO  ./textures/fakesouth.xpm

WE      ./textures/fakewest.xpm
EA 				./textures/fakeeast.xpm



F 220,100,255
 C 0,0,0

1111
1111
1
1111111111
1000000001
111100000111111   111
1000000N1000101  101
111111111111111   111

