

NO ./textures/fakenorth.xpm
SO  ./textures/fakesouth.xpm

WE      ./textures/fakewest.xpm
EA 				./textures/fakeeast.xpm



F 220,100,255
 C 0,0,0


11111
100N1  
11111    111     