

NO ./textures/fakenorth.xpm
SO  ./textures/fakesouth.xpm

WE      ./textures/fakewest.xpm
EA 				./textures/fakeeast.xpm



F 220,100,255
 C 0,0,0


1111111111
1000000001
111100000111111   111
10000000W1000101  101
111111111111111   111

