

NO ./textures/fakenorth.xpm
SO  ./textures/fakesouth.xpm

WE      ./textures/fakewest.xpm
EA 				./textures/fakeeast.xpm



F 220,100,255
 C 0,0,0


111N
0000
11111    1111
11111   